############################################################
#@ #  ##     #           #        #           #           #
# ###  #  #  #  #########  #####  #  #########  #########  #
#     ##  #  #  #        #     #  #  #              #     #
#  #  ##  #  #  #  #####  #####   ##  #####   #####  #  ###
#  #  ##  #  #  #  #           #  ##        #        #     #
#  #  ##  #  #  #  #  #######  #  ##  #####  #  #####  #  #
#  #  ##  #  #  #  #              ##  #     #  #     #  #  #
#  #  ##  #  #  #  ##########  #  ##  #####  #  #####  #  #
#  #  ##  #  #  #             #  ##           #        #  #
#  #  ##  #  #  #############  ##  ############  #####  #  #
#  #  ##  #  #                 ##                   #  #  #
#  #  ##  #  ###################  ###############  #  #  #
#  #  ##  #                        #               #  #  #
#  #  ############################  #############  #  #
#  #                                                      #
############################################################
