#####################################################################################################################################################################################
#  #        #        #        #           #                 #        #        #  #        #        #              #     #  #        #              #  #           #        #        #
#  #  ####  #######  ####  #  #  #  #  #######  #############  #######  ####  #  #######  #  #######  #  #  ####  #  ####  ####  #  #  #######  ####  #  #  ####  ####  ####  ####  #
#        #        #     #  #     #  #     #     #                          #     #  #  #     #  #  #  #  #     #  #        #     #     #                 #  #                 #     #
#  #######  #  #  #  ####  #  #######  #  ####  #############  ####  #  #  ####  #  #  #  ####  #  #######  #######  ####  #######  #  ####  #  #######  #  #  ####  #  #############
#     #     #  #  #  #     #  #        #     #  #  #     #        #  #  #  #  #        #                          #  #     #     #  #     #  #  #        #  #  #     #     #        #
#  #  #  #######  #  #######  #  #  #######  #  #  #  ###################  #  #  ####  #  ####  #  ####  ####  ####  ####  #  ################  ##########  #  ####  #  ####  ####  #
#  #  #  #           #        #  #  #                    #        #        #  #     #        #  #  #     #  #     #  #     #  #     #                    #  #  #  #  #     #  #  #  #
#  ##########  ####  #  #######  #  #######  #############  #  #######  #  #  #  ######################  #  #  #######  ####  ####  ##########  #  ####  #######  #  #######  #  ####
#  #     #  #  #     #     #  #  #     #  #  #           #  #           #  #        #  #  #  #     #     #  #           #           #  #        #  #  #  #  #     #     #     #     #
####  ####  #  #  ####  ####  ####  ####  #  #  ####  ###################  ##########  #  #  #  ####  ####  ####  ####  ####  #  #  #  ####  ####  #  ####  ####  #######  ####  #  #
#  #           #                 #  #     #     #  #     #     #  #  #     #                          #     #  #     #     #  #  #  #           #  #                       #     #  #
#  #######  ####  ####  #  #  #  #######  #  ####  ####  ####  #  #  ##########  #  #  #  ####  ##########  #  #  ####  #  #######  ####  ####  ##########  #############  ####  ####
#  #  #        #  #  #  #  #  #           #  #                 #     #     #  #  #  #  #     #     #  #        #  #     #  #           #  #        #     #        #           #     #
#  #  #  ####  ####  ##########  #######  #######  ####  ####  #  #######  #  #  #############  ####  #  #  #  #  ##########  #  ####  #  #  #  #  #  #  ##########  ####  #######  #
#        #     #     #     #  #        #     #        #  #     #     #     #     #  #                 #  #  #  #           #  #     #     #  #  #  #  #  #           #  #  #  #     #
#  #  #######  ####  #  ####  #  #  ##########  ####  #############  #  #######  #  ####  ####  #  #  #  ####  ####  ##########  #  ##########  ####  ##########  ####  ####  #  ####
#  #  #  #        #     #  #  #  #     #        #     #  #  #     #     #  #  #  #  #        #  #  #     #        #  #        #  #  #                    #     #        #     #     #
#######  #  #  #  #  #  #  #  #  #  ####  ####  #######  #  ####  #  #  #  #  ####  #  ##########  #  ################  #############  ####  #  ####  #  #  #  ####  #  #  #######  #
#     #     #  #  #  #        #  #  #  #  #     #        #           #        #           #     #  #  #     #  #     #              #  #     #     #  #     #     #  #     #        #
#  ####  ####  ####  ################  #  #  #  ####  #  ####  ##########  ####  ####  ####  ####  #######  #  ####  #  #  ##########  #############  #############  #######  ####  #
#        #           #     #     #  #     #  #     #  #              #     #     #  #     #     #              #        #  #  #  #     #  #  #     #  #     #              #  #  #  #
#############  #  #  ####  #  #  #  ##########  #######  #######  ####  #  #######  #  ####  #######  #  #######  #######  #  #  #######  #  #  #  #  ####  #  #############  #  #  #
#  #           #  #        #  #              #  #        #  #     #  #  #        #  #              #  #     #        #        #     #        #  #        #     #  #              #  #
#  #######  #  ##########  #######  ####  #######  #  ####  #  #  #  #  #  #######  ####  #############  #  ####  ##########  #  ##########  ####  #  ####  ####  #  #######  ####  #
#  #  #     #        #  #        #  #  #     #  #  #        #  #  #     #                 #     #     #  #              #     #  #  #     #        #              #     #  #     #  #
#  #  ################  #  ####  ####  ####  #  #  #######  #######  ####  ##########  #  #  ####  #######  ####  #######  #  #  #  #  #  #  #  #  ####  #######  #  #  #  ####  #  #
#           #     #  #        #  #        #              #     #     #     #        #  #        #        #     #     #  #  #     #     #     #  #     #     #  #     #  #        #  #
##########  ####  #  ####  ####  #######  ####  ####  ####  #  #############  #  #  #######  ####  #  ################  #######  #  ##########  ##########  #  #######  #######  ####
#     #  #              #     #  #  #           #     #     #  #  #  #  #  #  #  #                 #  #  #  #        #        #     #     #           #  #  #           #     #     #
####  #  #  #############  ####  #  ####  #  #######  ##########  #  #  #  #  ###################  ####  #  #######  ####  #  ##########  ####  #  ####  ####  ####  ####  #######  #
#     #  #              #  #     #     #  #  #  #           #  #              #  #     #        #     #        #  #  #     #        #        #  #     #     #  #  #        #  #  #  #
#  ####  #  #######  ##########  #  #######  #  #  #######  #  ####  ####  #  #  #  #  #######  #  #  #  ####  #  #  #  ####  #  #######  #  ####  #######  ####  ##########  #  #  #
#              #     #     #  #              #           #  #  #     #  #  #        #     #  #     #  #     #  #           #  #        #  #     #     #  #        #     #        #  #
####  #######  #  #  ####  #  ####  #  #  #######  ##########  #  ####  ####  #######  ####  #  ####  #  ##########  #  #  ###################  ####  #  #  #######  #  #  ####  #  #
#  #  #        #  #  #  #        #  #  #     #  #  #  #  #  #        #           #  #  #           #        #        #  #  #                    #  #                 #  #     #  #  #
#  ####  ####  #######  ####  ####  ##########  #  #  #  #  #  #######  #  #  ####  #  #  ####  ####  ##########  ####  #  #  ####  #############  #  ##########  #############  ####
#           #  #              #  #              #        #     #     #  #  #  #  #  #  #     #  #  #              #     #  #     #     #                 #           #  #           #
#  #######  ##########  #  #  #  #######  ##########  #######  ####  #######  #  #  ####  #  ####  #  ####  #############  #  ################  ##########  ####  ####  #  #######  #
#  #     #  #     #     #  #        #        #  #        #     #        #  #        #     #  #  #     #        #  #        #                 #  #        #     #           #     #  #
#  ####  #######  ####  ##########  ####  #  #  #############  #  ####  #  #  #######  #  ####  ####  ##########  #  #  ####  #  ####  #  ##########  #  ##########  ##########  ####
#        #        #     #  #        #  #  #     #  #           #     #  #  #        #  #        #     #  #  #        #     #  #  #     #     #     #  #  #  #        #              #
#######  #  #  #######  #  #######  #  #  #######  #  #######  #  ####  #  #  ####  #######  #######  #  #  #  ####  ####  #######  #######  #  #  ####  #  ####  ####  ####  #######
#  #     #  #  #  #  #  #                 #     #     #  #        #     #  #  #        #  #  #     #     #  #     #  #     #  #     #     #  #  #  #  #        #        #           #
#  #  ####  ####  #  ##########  #############  #######  ##########  #  #  #######  ####  #  #  #######  #  ####  #######  #  #  #  ####  #  ####  #  ####  ####  ####  #############
#  #     #     #  #  #     #        #  #     #        #  #           #  #        #  #     #  #     #  #  #     #  #     #  #     #     #     #  #     #     #     #                 #
#  #  ####  ####  #  #  #  #  #  ####  #  #######  ####  #  ####  #  #  #  #  #  #######  #  ####  #  #######  #  #  #  #  ####  #############  ####  #  #  #  #######  ####  ####  #
#     #                 #  #  #  #                 #        #  #  #  #     #  #     #                          #  #  #     #        #     #        #     #  #        #  #  #     #  #
#  #######  #  #  #  ##########  ####  #  #############  ####  #  ##########  #######  ##########  #######  ##########  #  ####  #  ####  ####  ####  #  #  #######  #  #  #  ####  #
#  #     #  #  #  #     #  #  #     #  #     #     #     #     #        #     #  #           #        #     #  #     #  #        #           #  #     #  #     #     #  #  #  #  #  #
#  #  ####  #  #  #######  #  #  #  #  ####  #  #############  #  #  #  ####  #  #  #############  #  ####  #  #  #######  #######  ##########  #  #  #######  #  #  ####  #  #  ####
#        #  #  #        #     #  #  #  #                 #        #  #     #  #  #        #  #     #     #     #        #        #  #  #  #        #  #     #  #  #  #     #        #
#######  #  ####  #######  ####  ##########  ####  #######  ####  ####  #######  ##########  ####  #  #  #######  ####  #  ####  ####  #  #  #######  ####  #######  ####  ####  ####
#     #        #                 #  #        #        #     #        #     #  #  #           #     #  #  #     #  #           #  #  #     #  #  #                             #  #  #
#  #  ####  #  #  ################  #  ####  ##########  #  ####  #  #######  #  ####  #  ####  #######  ####  #  ####  ####  #  #  ####  #  #  #  ####  #  #######  #  #  #  ####  #
#  #     #  #  #        #        #  #  #                 #  #     #  #        #        #     #  #        #     #  #  #  #  #  #  #     #     #        #  #     #  #  #  #  #     #  #
####  #######  ####  ####  #######  #  #######  ####  #  #######  ##########  #  ####  #############  #######  ####  #  #  ####  #  #  #######  #######  #######  #############  #  #
#                 #           #  #        #        #  #        #  #  #           #     #                          #     #     #  #  #  #  #     #     #  #           #  #     #     #
#######  #  ####  ####  ####  #  #  #  #############  ##########  #  #  #  #  #  ####  ####  #######  #  ####  #  #  #######  #  #  #  #  ####  ####  ####  ####  ####  #  #######  #
#        #  #        #     #  #     #     #           #              #  #  #  #     #           #     #     #  #  #           #  #  #                       #     #                 #
##################################################################################################################################################################################### 