#############################################################
#         #  #     #     #  #     #       C     #  #  #    #
#  ####  #  #  ####  #  #  #  ####  #  ####  ####  #  #  ####
# @#     #  #        #  #           #     #           #     #
####  ####  ####  #  #  ####  #  #  ####  #  ####  #  ####  #
#  #  #     #  #  #  #  #  #  #  #  #     #  #  #  #        #
#  #  ####  #  #  ##A#  #  ##########  ####  #  #  ##########
#                 #  #                 #        #          w#
#  ##########  ####  ####  ####  #  ##########  ####  #  ####
#        #  #  #     #  #     #  #  #                 #     #
#######  #  ####  #  #  #  ####  #  ####  #  #######  ####  #
#  #              #        #  #  #  #     #  #              #
#  ##########  #############  #  #  #  #  ####  #  #  #  #  #
#  #                 #  #        #  B  #  #  #  #  #  #  #  #
#  #  ##########  ####  #  #######  #######  #  #######  #  #
#        #     #  #     #  #     #  #                &#  #  #
####  ####  ####  ####  ####  #######  #  #######  ##########
#     #  #     #  #           #  #  #  #     #        #     #
#  #  #  #  #  #  #  ####  ####  #  #  #  ####  ####  #  ####
#  #     #  #          D               #     #     #        #
#############################################################