#############################################################
#        #  #     #     #  #     #        #     #  #  #     #
#  ####  #  #  ####  #  #  #  ####  #  ####  ####  #  #  ####
# @#     #  #        #  #           #     #     #     #     #
####  ####  ####  #  #  ####  #  #  ####  #  ####  #  ####  #
#  #  #     #  #  #  #  #  #  #  #  #     #  #  #  #        #
#  #  ####  #  #  ##A#  #  ##########  ####  #  #  ##########
#                 #  #  #              #        #     #   w #
#  ##########  ####  ####  ####  #  ##########  ####  #  ####
#        #  #  #     #  #     #  #  #                 #     #
#######  #  ####  #  #  #  ####  #  ####  #  #######  ####  #
#  #              #        #  #  #  #     #  #              #
#  ##########  #############  #  #  #  #  ####  #  #  #  #  #
#  #                 #  #        #  #  #  #  #  #  #  #  #  #
#  #  ##########  ####  #  #######  #######  #  #######  #  #
#        #     #  #     #  #     #  #                &#  #  #
####  ####  ####  ####  ####  #######  #  #######  ##########
#     #  #     #  #           #  #  #  #     #        #     #
#  #  #  #  #  #  #  ####  ####  #  #  #  ####  ####  #  ####
#  #     #  #          #               #     #     #        #
#############################################################