###################
#@               &#
###################
#                 #
###################